...............
...............
...............
####.......####
...............
...............
....#######....
...............
...............
####.......####
...............
...............
...............
.....#####.....
...............
