...............
...............
.....#...#.....
..####...####..
...............
...............
......###......
.....#####.....
......###......
...............
...............
..####...####..
.....#...#.....
...............
...............