...............
...............
.....#...#.....
..####...####..
...............
...............
......###......
...............
......###......
.....#...#.....
...............
....##...##....
.....#...#.....
...............
...............